一个人，挺好的	一个定的，没有买	是买来到了
我是装电脑都是电脑上挺好	我是装电脑都是电脑上有安装	我是装电脑都是电脑上的
是的，通用移动移动移动移动移动	我是通用移动通用移动	是的，通用移动移动移动移动移动移
看你蓝牙	看你你蓝牙	看你为为为
盒子一直用	盒盒盒盒盒子	盒盒盒盒子
都可以	都是的，	都是，我
质量很好，	质量很可以，	质量可以，
我们们们，触触触触触触触触触	我们们们，触触触触触触触触触触	我们们们，触触触触触触触触控，
好用	我是可	可以，
s9999	家看你会有问	999
用的有	在用，打	在用的
我的是联系统	我的是，我买了	我的是，我的有
看你车，我的有电脑上的有	看你车，我的有电脑上的车车车了，看看看有	看你车，我的有电脑上的有
可以，是是是蓝牙可以，	可以，是是是蓝牙是可以，	可以，是是是是蓝牙
主板，主板是主板，主板在主板主板主板主	主板，主板是主板，主板主板主板主板主板主	主板，主板是主板，主板在那那那个
我买了，是手机是电脑用的	我买了，是手机一个	我买了，是手的用了
我是一样	我是要自己	我是一个人
我买了还可以	没有，我买了还	我买来也没有
感觉可以，感觉可以了，没啥啥啥啥啥啥啥啥	感觉可以，感觉可以了，感觉得啥啥啥啥啥	感觉没啥啥啥啥啥啥啥啥啥啥啥啥啥啥啥啥啥
防水，没试过水水，我没试过	防水，没试过水水，没试过	防水，没试过水水的，没试过
我是到了，没啥用	我是到了，没什么问	我是到了，没啥啥用
可以用，我是挺好，挺好看的	可以用，挺好，挺好看的	可以用，我是挺好，用的！
黑色的	黑色，	黑色可以
这是是是是是是包装的！	这是是是是是是是的，包装	这是包装的！
我是黑黑，也也也也也也也也也也也也也也也也	我是黑黑，通用过来也也也也也也也也也也很	我是黑黑，通用过来也也也也也也也也也也也很
我买的	我也是	我买来黑
挺好用的	是充电脑的	是充电脑脑
可以用	可以的	可以呀
可以，有耳机	可以耳机	可以，耳机
1.5.5	1.5.1	1.5.11
好像是正常	好像是你点	好像是你点，
要是买来有档档档档档档档档档档档档档档档	有啊！	有档档档档档档档档档档档档档档档档档档档
我是电的，我是正品，	我是电脑的	我是电的，没有问题。
看信号	看你的4	看信信号
我是没有个	我买了好	我没有小米
我是蓝牙了	我是用了几天，你没有也没有耳机	我是用了几天，你没有也没有电
我的是货，那个月，那么用着还可以	我买来可以的	我的是可以，那个月在口货，放心购买
我是没有什么用着着着在为了	我是没有什么用着着在为了	我是没有什么用着着在要按
我是看你可以用的	我是看你用了一样，	看你可以用
是的	一般	我是的
我们有点可以	我们有点除	我们有配配配配
有耳机	有蓝牙	有，可以
一般盒	盒子是盒	吃盒子是
耳机有耳机	耳机有耳机有	需要看用
没有送，一般都是电话，没有送货	没有送，一般都是电话，没有送送货	没有送，一般都是电话，但是送货
我是打的没有用，打打电话，没有	我是蓝牙没有用，打打电话，没有	我是打的没有用，打打打电话，没有
可以的	我也是，	我的也是
有太太太太太多了，我了	看你了，没有问题	有太太太太太了，我是可以
还可以	看看可以	看看看可
配置置	配可以，	可以，家
我也是	我是的	我用
洗衣机没有洗衣洗。	洗衣机没有洗衣衣洗。	洗衣机没有洗衣衣衣洗
可以了，	是，可以用了，	是，可以用着着可以，
可以，设置	可以，设置是	可以，去看是
1.111--------------	1.1111-------------	没试过
有点，是正常	有点，是正品，	有点，是正常使
好像是充电	好像是触是定	好像是蓝牙
没有啊，我就没有千千千千千千千千千千千千	没有啊，我就没有千千千千千兆	没有啊，我就没有千千千千兆
联系统，都是联通的	联系统，都是联通通	我的也是，都是联系统
水客服	用水客服	用，水客
我用了有没有啊	我用了，没有用过	我用了有没有，我
好像在喝，就很好了	好像在喝，就会会有啊	有点小米啊
有一接了，打开始你用	有一接了，打开始始你了	有一接了，打开始始始始
可以看	可以看说	我买了几
可以看电脑上下单，下单，下载了。如果可以哦	可以看电脑上下单，下单，下载了。如果看电	可以看电脑上下单，下载了一个月份份份份
看你们有	看你们都好	看你自己的
我用了一个	我是自己买了	我是看看自己
果是直用来来来来来！	果是直用来来来来来来！	有点装的，但是来来一直
我也没有什么用	我是2小米	我是2s！
用着是可以，，，设置，	要是有，设置一样，要是有设置，，要坚坚装	要是有，设置一直接口口口要设置，要要要车
有，可以看有，有太可以看有，有，有自己有	有，可以看有，有太可以看有，有自己有可以	有，是可以看有，有自己有太太太太可以，
需信号可以	需要看信信信	需要看电话
看说明书	看安装，我	看安装，没
有一个蓝牙，配置	有一般	有一个手机
车自己车里	还行车里	车里面有点发
我也是	我也是，	联系客服
看你电视频	看你电视，挺	看你电话
用了一下就用	用了一下就可以	用了没用
配置，配蓝牙	然然然，配蓝牙	然然然有，配蓝
需要	是的，	蓝牙
看有配置	看有多了，	看有用，看
需要自己装	需要看有配有	需要自己装，
我是小米没有，可以用手机	我是小米没有，可以用这种小	我是小米没有，可以用这种热
是的，我没有移动移动自己买	是的，我没有移动自己买	是的，我没有移动自己买
黑色的	有	有黑色
我是看自己的，我是正常的，我是是看自己是	我是看自己的，我是正常的，我是是是看自己	我是看自己的，我是正常的，我是是看自己的
可以，你自己买来，你可以看看看看看你	可以，你自己买来，可以看你自己看看你	可以，你自己看你自己能是看看自己看自己
可以，有一样，没有么么么么态了	可以，有一样，没有么么么态了	可以，有一样，没有充
送货，有电	送货，送货	送货，就是小
看看看看看看看看，看看看看看看看看看看你	看看看看看看看，看看看看看看看看看看看你	是看看看看看看看看来来来来没有
黑色，全	我的也是	我还可以
可以了	我是自己	我是我是
还可以	我的是正	还行，我
我是卡卡，可以	我是卡可以	我是卡卡可以
看你去，我是看你看！	看你去，我是看看你你！	看你去，我是看你买了
我的有配有	我的有一样	我的有有
看	全网	送的
有了	好像是	我买了
我的也是，就是一次次，放放心购买	我的也是，就是一般！	我的也是，就是一次次，就是一次次次
我是有了能在线了，可以用了	我是有了能在线了能在好	我是有了能在线了，可以用了能
支持，只有音量音！	支持，只有要有音！	支持，只有要求音！
可以，是是有个卡，可以调节有个小米是需要	可以，是是有个卡，可以调节有个小时	可以，是是有个卡，可以调节有个小米可以调
可以了	可以了。	安卓和用
需要加购买来分钟，加加加加加加加加会。	需要加加购买来分钟，加加加加加加加加会	需要加加购买来会。
看看看看看看说明书和和和和和和和和和和和和	看看看看看看说明书！	挺好的！
我的没有，挺好用的	我的没有，看看看看看	我的没有，挺快的
我们们都是可以用时候	我们都是可以放心购买，我	我们都是可以用时候
可以，我是放心买的	可以，我是打的上，一	可以，我是打的打开始
现在大，没有打开始	打开始有	现在也很可以
可以，我家	可以，我们一	可以，我买的
我觉得很好用，打开自己去是可以放在在在在	我觉得很好用的，打开自己是可以放在在在在	我觉得很好用的，我用的是可以放在去
用了	有打打	有--
4g	全是全	全屏幕
可以看	可以看你	可以看看
我买了，可以的问题	我买了，可以用了，没	我买了，没有线
问客服	你问客服	如果没有
华为为为为的耳机	华为为为的耳机	华为为为的耳机都是
要是器，4g器	要是器，但是	要是器，4g够
可以用，我是可以调节了，我是5.1g	可以用，我是可以调节了，我是5.11g	可以用，我是可以调节了，我是5.1gg
很好，挺挺好的	很好，但是普通	很好，但是正品的
我的是通用了几次	我的是通用了几天	我的是通用过时候2
可以，我的有存存，很好用	可以，我的有存存，或者在很	我的有反应可以用的
蓝牙就可以，但是要的，但是要好用的	蓝牙是全就可以，但是要下的	蓝牙就可以，但是要的，但是要开，
可以的，我是安装的	可以的，我是正常好	可以的，我是安装自己
可以呀	可以看有点自己	可以看有点分
我买的是水果	我买过！	我买过！挺好的
车车车车	车车车上	车车车车车
没注意	打电话，	没注意过
看你去是是有	看你去是是可以	看你去有
可以	可能有	可以的
我是手通用的	我是手一样	我是手机+的
g信信信信信信用！	通用信号可以	g信信信信信号
可以，我买了	可以，但是个音	可以，我的直接
我是太太太太太太可以了	我是太太太太太快了	我是太太太太太可以了
我的家里	我是电脑的	我是器的呢
我的是，可以我的	可以我的呀	可以我的安装
我是自己买	有	有太，自己的
我买了，可以了	我的没有，可以了	我的也是，可以了
送货，我是5.5.5.5g，	送货，我是5.5.5.5g，我	送货，我是5-5.5.5.5g
我买的是为了	我买的挺好	我买的是用的，
看你可以了	看子！	看子，可以了
我是全新用，我买了	我是全新用，我也是	我是全新用，我用了
可以看	可以，我	可以用
看是线连接线连接线连接线连接线连接线	看是线连接线连接车车车车车车车车车车车	看是线连接车车车车车车车车车车车就可以
我用了一样	我们用的是可	我用了一般
有，可以用着有，有有有，有有有有有有有有效	有，可以用着有，有有有，可以用	有，可以有有有有，只有有有有有有有有有有有效
您好，我是可以的	您好，我是可以用的	您好，我是可以的，
有线网络就能用	有线网络有线就能	有线网络就能吃
我家家有了一个左右	我是家家有了，但是是	我是家有了一个
我也是	我家有一	
在新品，自己去，自己去，可以装在在在在在	在新品，自己去，自己去的	在新品，自己去，自己去的
我3.2	我也是	我3天都是
我的也是，可以看看耳机	我的也是，可以看看！	我用了看耳机
我看信用4g信用的	我看信用4g信信用的	我信用的
我的是	我的是2	我的是的
我是可以发货	我是可以用，可	好像是可以
是，安装，没有	需要自动	安装，没有
这个是有的，没有的水	这个是，没有的还是没有	这个是，没有的水
是，很快	是，只是正	是，只是有
无无无无无无无无无无无无无无无无无无无无	无无无无无无无无无无无无无无无无无无无法	无无无无无无无无无无无无无无无无法
信号可以，没有遇到过	没有，挺好用的	没有，你过，你要是电脑
通用	看你们	可以
有耳机	看你耳机	有，可以
我买的有	我的有送来	我的也有
	有	可
有说明，有！	有配配配配配配	有配配配置
能用了	可以。	一般都有
我也没有	我也没有通	我没有移过
你可以，在在在在在在在线充电，在在在在在在	你可以，在在在在在在在线充电，下载心，可	你可以，在下单单单单单单单单单单单单单
看你自己去看看看有送货	看你自己去看看到了	看你自己去看看有说明
没有，我是用的！	没有，也是用了	没有，我是用的也是
好像有点就可以	好像有点，我们们	看你的，我家家家
我的是看了，可以用了	我的可以用了，我就是一	我手机了一个月了，可以
没有，，，，，，，，按键可以放心是，按按	没有，，，，，，，需要求，按按键有电脑一个	没有，，，，，，，，按键可以放心是按键
可以，我一个没有用	可以，我一般用的！	可以，我一个用的！
我是手机	我买的是手	我的是手机
我觉得可以	我觉得还是可	我自己买
你好像没有，但是要自己去就是水	你好像是水，但是通通就是水	你好像没有，但是要自己去，但是水
这款是安装，都是一样，包装，一下家家家家	这款是家里面有，但是要看看你们们们们	这款是安装，都是一样，包装，一般般般般
有电信可以用，	是调电信信号，	是调电信信信号，
可以，是正常	可以，打开机机好像是一个卡，可以打开机	可以，没问题，看你自己
我的移动卡	我的移动卡都	我的也是
我是小米	我是小卡，	我是小，我
没有在在在在在在在在在机	热水装在机	没有在在在在在在在在在上面
我的是的，是通用的	是的，我是通用的	我的是的，是有移动动
可以的	我是有的	我是的，
是全网通	是，通话，	是全网络络
我的是在线，我用了一样	我的是在线，我用了，我这	我的是在线，我的用了
我是车车车车车车车车车车车车车车车车车	我是看耳机有耳机	我是看耳机的
看看去有有用，看看到有有没有有有有有有	看看去有有用，看看到有有点自己看看看看看	看看去有有有有有有有有有有点
好像是为了电脑好。	好像是为了电脑好，好	好像是，好像是电脑上
正常，我买了	我买了一个，蓝	我买了个月，反
我是太小时，自己看说明书了	我是太小时，我的也是太好	我是太小时，自己看到了
我的是一样，可以看看说	我的是看看有，可以看说	我一样，可以看看看说
我的也是	我的是	我是也是
我是黑色的	我买的是	我是黑色，
在appapp	在微信信	在appappapp
我是好用的	可以，我是需	我是可以放时
手机信用	手机充电信	手机用
我的可以了	看你自己去了	我的充电
有点多了	有点多少	有点多大
无线可以，无线网线系统自己无线客服	无线网线自己无线线线系统，无线客服有	无线可以，线网线系统自己无线客服
我也是	我也是，	我也没有
我是温度	我是温度有	我是温度可
是有打打g	是有打g	是打g
我是一个，一是用来来自己个，我是一个了	我是一个，一是用来来自己个，一个了一个是	我是一个，一是用来吃了，一个是5-5接
，是手机的	，是需要买，	，是手机充电
在4.888888888888888，	在4.8888888888888888	在888888888888888888
屏幕就可以	屏幕就是全屏	屏幕就可以，
